东门	SYS_OTHER
齐齐哈尔火车站	SYS_OTHER
不需要	SYS_OTHER
金石市靖西客运站	SYS_OTHER
奥丰汽修	SYS_OTHER
唉	SYS_OTHER
医院	SYS_OTHER
船厂	SYS_OTHER
需要	SYS_OTHER
长安区航天	SYS_OTHER
附近最近的工商银行	SYS_OTHER
多远	SYS_OTHER
旧宫镇德南路星红工业园	SYS_OTHER
华城宾馆	SYS_OTHER
我要去调兵山金源小区十一号楼	SYS_OTHER
到沧州博物馆	SYS_OTHER
在哪	SYS_OTHER
我要去周至县小留村	SYS_OTHER
湖塘	SYS_OTHER
导航到	SYS_OTHER
去发的他发的这个位置	SYS_OTHER
伦洋大厦	SYS_OTHER
七星台	SYS_OTHER
停车场	SYS_OTHER
渔村	SYS_OTHER
去最近的那个	SYS_OTHER
频道	SYS_OTHER
聚景园	SYS_OTHER
酒店	SYS_OTHER
帮我找一个最近的李先生	SYS_OTHER
打洛小镇	SYS_OTHER
去皇朝万鑫	SYS_OTHER
小度那个这个限号怎么能忘了	SYS_OTHER
给我查一下最近的地铁站	SYS_OTHER
导航	SYS_OTHER
崂山区董村	SYS_OTHER
请问沙公高速通了没有	SYS_OTHER
到成都医院	SYS_OTHER
区	SYS_OTHER
嘉园	SYS_OTHER
小度小度	SYS_OTHER
第一个	SYS_OTHER
几点到达目的地	SYS_OTHER
我酒店	SYS_OTHER
肿瘤医院	SYS_OTHER
锦绣花园	SYS_OTHER
赵静	SYS_OTHER
白天模式	SYS_OTHER
国际大酒店高铁东站店	SYS_OTHER
诗经里	SYS_OTHER
火车站	SYS_OTHER
榆垡桥	SYS_OTHER
宝鑫生活区北门	SYS_OTHER
小度小度我要找附近酒店	SYS_OTHER
崇礼蓝鲸凯悦酒店	SYS_OTHER
叫你走宾馆	SYS_OTHER
往复朴家村王花马屯	SYS_OTHER
小度小度	SYS_OTHER
服务区	SYS_OTHER
大悦城	SYS_OTHER
台前累了可以聊聊天可以吗	SYS_OTHER
水果	SYS_OTHER
陕西省	SYS_OTHER
是吗	SYS_OTHER
皇后	SYS_OTHER
医院	SYS_OTHER
导航到新疆大学	SYS_OTHER
度小度	SYS_OTHER
去约克了	SYS_OTHER
不需要	SYS_OTHER
山西省运城市临猗县	SYS_OTHER
北小营服务区	SYS_OTHER
最近的加油站	SYS_OTHER
可以	SYS_OTHER
开车	SYS_OTHER
回家	SYS_OTHER
我的行程	SYS_OTHER
太原北站	SYS_OTHER
六工镇沙梁子村	SYS_OTHER
小度小度导航到西太村	SYS_OTHER
去首都机场t3航站楼	SYS_OTHER
不需要	SYS_OTHER
地铁	SYS_OTHER
第一个	SYS_OTHER
承德双滦北收费站	SYS_OTHER
去民族文化宫大剧院停车场	SYS_OTHER
小度小度	SYS_OTHER
不需要	SYS_OTHER
嘉兴市新义小区	SYS_OTHER
这点	SYS_OTHER
到中国农科院	SYS_OTHER
桃仙机场t3接机口	SYS_OTHER
小鹿小鹿	SYS_OTHER
小度小度	SYS_OTHER
附近饭店	SYS_OTHER
需要更换芳	SYS_OTHER
去八面通	SYS_OTHER
开始导航	SYS_OTHER
去小水口	SYS_OTHER
导航二百玲泰山路209号	SYS_OTHER
想朝阳到阜新坐火车得多长时间	TRAIN_TICKETAIR_TICKET
帮我查找一下8月8号的火车票从武汉市到重庆市	TRAIN_TICKETAIR_TICKET
小度离成都高铁还有多长时间	TRAIN_TICKETAIR_TICKET
衡水到北京的火车票	TRAIN_TICKETAIR_TICKET
十一买票	TRAIN_TICKETAIR_TICKET
从石家庄坐高铁大概多长时间到郑州	TRAIN_TICKETAIR_TICKET
昨天买票了	TRAIN_TICKETAIR_TICKET
从福州到六盘水火车	TRAIN_TICKETAIR_TICKET
北京到乌兰浩特的火车下午几点开车	TRAIN_TICKETAIR_TICKET
天津市到鄂尔多斯有没有直达火车	TRAIN_TICKETAIR_TICKET
雅林园到大连坐火车得多长时间	TRAIN_TICKETAIR_TICKET
坐火车从渭南到日照多长时间	TRAIN_TICKETAIR_TICKET
天津到昭通火车	TRAIN_TICKETAIR_TICKET
唐山到宁波的火车有没有	TRAIN_TICKETAIR_TICKET
牡丹江到绥化几点火车	TRAIN_TICKETAIR_TICKET
塔城的火车票多少钱	TRAIN_TICKETAIR_TICKET
哪里有票	TRAIN_TICKETAIR_TICKET
南昌到宜春高铁	TRAIN_TICKETAIR_TICKET
阳泉到石家庄的火车今天几点到	TRAIN_TICKETAIR_TICKET
票在哪里	TRAIN_TICKETAIR_TICKET
坐高铁从潍坊到青岛多长时间	TRAIN_TICKETAIR_TICKET
小度小度富士庄园的票多少钱	TRAIN_TICKETAIR_TICKET
预订从西安到北京的高铁票	TRAIN_TICKETAIR_TICKET
火车票预订	TRAIN_TICKETAIR_TICKET
我让你买兰州到浠水的票啊十号的吧	TRAIN_TICKETAIR_TICKET
从清河到邯郸的火车几点	TRAIN_TICKETAIR_TICKET
蓬莱到滨州的动车有没有	TRAIN_TICKETAIR_TICKET
从郑州到南宁坐高铁	TRAIN_TICKETAIR_TICKET
在哪里买票	TRAIN_TICKETAIR_TICKET
火车到西安要多久	TRAIN_TICKETAIR_TICKET
济南到北戴河高铁多长时间	TRAIN_TICKETAIR_TICKET
大连到鞍山动车多长时间	TRAIN_TICKETAIR_TICKET
从北京到天津的火车	TRAIN_TICKETAIR_TICKET
有没有从定州到蚌埠的高铁直达	TRAIN_TICKETAIR_TICKET
坐火车从武汉到新疆要多长时间	TRAIN_TICKETAIR_TICKET
明天有票	TRAIN_TICKETAIR_TICKET
从太原去北京乘坐高铁需要多长时间	TRAIN_TICKETAIR_TICKET
从喀左到阜新站坐高铁	TRAIN_TICKETAIR_TICKET
坐高铁到西安市还有多长时间	TRAIN_TICKETAIR_TICKET
济南长途汽车站到滕州汽车站车票要多少钱	TRAIN_TICKETAIR_TICKET
小度小度从北京到西安的火车西安的火车票要多少钱	TRAIN_TICKETAIR_TICKET
雅林园到北京坐火车多长时间	TRAIN_TICKETAIR_TICKET
小度小度查一下东莞长安到贵州省威宁县的汽车票	TRAIN_TICKETAIR_TICKET
郑州到焦作市火车几点	TRAIN_TICKETAIR_TICKET
又是怎么了要是买车票又怎么了	TRAIN_TICKETAIR_TICKET
南京苏州到南京火车票几点	TRAIN_TICKETAIR_TICKET
小度小度嗯从那正定国际机场到石家庄高铁站需要多长时间	TRAIN_TICKETAIR_TICKET
从德州火车站到哈尔滨火车站坐火车需要多长时间	TRAIN_TICKETAIR_TICKET
票呵	TRAIN_TICKETAIR_TICKET
我要去票	TRAIN_TICKETAIR_TICKET
火车站大连现在多少钱	TRAIN_TICKETAIR_TICKET
长沙到北京火车	TRAIN_TICKETAIR_TICKET
多伦湖购票	TRAIN_TICKETAIR_TICKET
去个票	TRAIN_TICKETAIR_TICKET
订高铁票	TRAIN_TICKETAIR_TICKET
从北京到天津最快高铁需要多长时间	TRAIN_TICKETAIR_TICKET
北京到上海坐火车最快	TRAIN_TICKETAIR_TICKET
你好查一下从沈阳到承德的火车下午几点发	TRAIN_TICKETAIR_TICKET
成都南站至大连的车票	TRAIN_TICKETAIR_TICKET
徐州到武汉的火车票	TRAIN_TICKETAIR_TICKET
从我查一下福州买票到贵阳有没有今天的票	TRAIN_TICKETAIR_TICKET
火车从济南到临清	TRAIN_TICKETAIR_TICKET
从运城到德州火车	TRAIN_TICKETAIR_TICKET
换票12点10分	TRAIN_TICKETAIR_TICKET
广州高铁有没有山西到广州高铁	TRAIN_TICKETAIR_TICKET
郑州到武汉的火车票	TRAIN_TICKETAIR_TICKET
查一下今天下午有没有去洛阳的汽车票	TRAIN_TICKETAIR_TICKET
乌鲁木齐南站有没有去玛纳斯的火车	TRAIN_TICKETAIR_TICKET
票吗	TRAIN_TICKETAIR_TICKET
从山东菏泽到山东菏泽到安徽宿州坐火车车	TRAIN_TICKETAIR_TICKET
拉萨到西宁的火车票	TRAIN_TICKETAIR_TICKET
下午票	TRAIN_TICKETAIR_TICKET
四平到上海虹桥火车站动车有没有	TRAIN_TICKETAIR_TICKET
天津到运城坐k882	TRAIN_TICKETAIR_TICKET
栖霞汽车站到桃村火车站需要多长时间	TRAIN_TICKETAIR_TICKET
赤峰到承德坐火车的多长时间	TRAIN_TICKETAIR_TICKET
我买的票是明天的票吗在六号的票吗	TRAIN_TICKETAIR_TICKET
从淄博坐火车到胶州花多少钱	TRAIN_TICKETAIR_TICKET
梅河口到北京的火车票多少钱	TRAIN_TICKETAIR_TICKET
徐州有没有火车到济南的	TRAIN_TICKETAIR_TICKET
k340到北京多长时间	TRAIN_TICKETAIR_TICKET
要票	TRAIN_TICKETAIR_TICKET
郑州到西安火车几点	TRAIN_TICKETAIR_TICKET
从北京到承德的火车几点	TRAIN_TICKETAIR_TICKET
孝感站到洛阳的火车有没有今天下午的	TRAIN_TICKETAIR_TICKET
威海到乳山坐火车	TRAIN_TICKETAIR_TICKET
九台坐火车到大连有多长时间	TRAIN_TICKETAIR_TICKET
从佳木斯到天津火车	TRAIN_TICKETAIR_TICKET
去威海哈尔滨到威海的火车票多少钱	TRAIN_TICKETAIR_TICKET
从呼和浩特到山东烟台坐卧铺	TRAIN_TICKETAIR_TICKET
六里桥客运站到高铁站多长时间	TRAIN_TICKETAIR_TICKET
北京到西安的高铁	TRAIN_TICKETAIR_TICKET
能帮我买票吗	TRAIN_TICKETAIR_TICKET
沈阳到海拉尔的火车票	TRAIN_TICKETAIR_TICKET
从格尔木到兰州坐火车需要多长时间	TRAIN_TICKETAIR_TICKET
从咸阳到河北葫芦岛高铁	TRAIN_TICKETAIR_TICKET
从三河市出发坐动车到青岛需要多长时间	TRAIN_TICKETAIR_TICKET
明天早上枣庄到重庆的火车有没有	TRAIN_TICKETAIR_TICKET
从乌鲁木齐到界首坐火车多少钱	TRAIN_TICKETAIR_TICKET
我要我要你买票	TRAIN_TICKETAIR_TICKET
从高铁	TRAIN_TICKET
辽源四平火车	TRAIN_TICKET
我说的是北京西站火车站	TRAIN_TICKET
延吉到青岛的火车	TRAIN_TICKET
从四平坐火车去阜新	TRAIN_TICKET
哦快车	TRAIN_TICKET
小度我要去怀来火车站的锦江之星	TRAIN_TICKET
我想从厦门高崎机场做惠州的高铁	TRAIN_TICKET
郑州高铁郑州高铁站到二七广场	TRAIN_TICKET
我要坐火车去海南	TRAIN_TICKET
榆次到黑河的火车	TRAIN_TICKET
到商丘的高铁	TRAIN_TICKET
普通邯郸市峰峰	TRAIN_TICKET
到榆林的火车	TRAIN_TICKET
莒南高铁	TRAIN_TICKET
兴隆到绥化几点有火车今天	TRAIN_TICKET
哈尔滨到哈尔滨的高铁	TRAIN_TICKET
长春市公交列车时间表	TRAIN_TICKET
帮我查一下从临沂到北京的火车	TRAIN_TICKET
小度小度帮我查一下到那个山东的火车	TRAIN_TICKET
瓦房店动车	TRAIN_TICKET
从潍坊去榆林的火车有没有	TRAIN_TICKET
西宁至德令哈几点发车火车	TRAIN_TICKET
青堆到大连的高铁	TRAIN_TICKET
去武昌火车站吗从火车站	TRAIN_TICKET
北京西站到任丘火车	TRAIN_TICKET
坐火车可以去山东到了吗	TRAIN_TICKET
东安东站到德清火车站	TRAIN_TICKET
新郑火车票	TRAIN_TICKET
小度小度去介休高铁站	TRAIN_TICKET
锦州到昆明的火车	TRAIN_TICKET
小度小度去临汾西火车站	TRAIN_TICKET
我要到哈尔滨火车站坐火车	TRAIN_TICKET
k101	TRAIN_TICKET
广东东莞火车票	TRAIN_TICKET
我我是要去到聊城市的高铁	TRAIN_TICKET
嗯火车北客站	TRAIN_TICKET
黄州到麻城的火车站在哪里	TRAIN_TICKET
小度小度太原到临汾的高铁	TRAIN_TICKET
给我找一下本溪市火车站	TRAIN_TICKET
几点火车到安溪	TRAIN_TICKET
我要去邯郸市高铁高铁站	TRAIN_TICKET
黄陵的动车	TRAIN_TICKET
我要去和田地区火车站	TRAIN_TICKET
我要去买高铁	TRAIN_TICKET
查一下去青岛的火车	TRAIN_TICKET
小度小度g6	TRAIN_TICKET
我到北京南站坐高铁	TRAIN_TICKET
高铁阜新站	TRAIN_TICKET
武威到兰州几个小时坐火车	TRAIN_TICKET
到新疆的有到新疆的票的火车站	TRAIN_TICKET
在乾县火车站多久	TRAIN_TICKET
t9	TRAIN_TICKET
查一下张掖到兰州的火车今晚	TRAIN_TICKET
鸡西到虎林火车	TRAIN_TICKET
北京至凌源的火车	TRAIN_TICKET
榆次到兰州的火车啊啊啊	TRAIN_TICKET
北京到佳木斯的火车	TRAIN_TICKET
我要到乌兰察布盟集宁市火车站	TRAIN_TICKET
我要搭火车去常州	TRAIN_TICKET
通辽去兴城有火车站吗	TRAIN_TICKET
k73	TRAIN_TICKET
小度坐高铁去香港	TRAIN_TICKET
潍坊高铁	TRAIN_TICKET
哼坐火车去南京	TRAIN_TICKET
大洼到哈尔滨的火车	TRAIN_TICKET
天津南站去往北京西客站的火车	TRAIN_TICKET
孝感去襄阳的火车坐几点的	TRAIN_TICKET
想坐火车去拉萨	TRAIN_TICKET
高铁去那啥	TRAIN_TICKET
给我查一下长春到广州的火车	TRAIN_TICKET
我要我要洛阳到锦州的火车时刻表	TRAIN_TICKET
东营到济南火车	TRAIN_TICKET
到哈尔滨高铁还有票吗	TRAIN_TICKET
从牛角沱到重庆高铁站	TRAIN_TICKET
我要从武威坐到贵阳坐火车	TRAIN_TICKET
达坂城g30	TRAIN_TICKET
从香河到938北京站	TRAIN_TICKET
去吉林省桦甸市坐火车怎么走	TRAIN_TICKET
崇文今天从潍坊到深圳的火车	TRAIN_TICKET
火车站乌鲁木齐火车站在哪	TRAIN_TICKET
小度小度你好佳木斯去长春西站火车时刻表	TRAIN_TICKET
茌平有没有卖火车票的	TRAIN_TICKET
蓬莱到烟台的高铁	TRAIN_TICKET
从白洋淀站到唐山的火车票	TRAIN_TICKET
从洛阳到宁波的火车	TRAIN_TICKET
今天有没有去苏州的火车	TRAIN_TICKET
保定至天津的火车	TRAIN_TICKET
从玉泉镇到哈尔滨东站的火车	TRAIN_TICKET
我从德州到新疆坐火车	TRAIN_TICKET
小度小度滕州市高铁站	TRAIN_TICKET
盘锦坐火车到金州大连金州	TRAIN_TICKET
西安到陇南火车	TRAIN_TICKET
林东到太原火车	TRAIN_TICKET
坐高铁去杭州	TRAIN_TICKET
小度小度我我要去赤峰市宁宁城县火车站	TRAIN_TICKET
去郑州到云南昆明火车票	TRAIN_TICKET
去龙卢龙县有火车吗	TRAIN_TICKET
石家庄到福建泉州的火车	TRAIN_TICKET
火车哈尔滨西	TRAIN_TICKET
今天河北的天气	WEATHER
南通有雨吗	WEATHER
健康有没有	WEATHER
西湖鲍村天气	WEATHER
北京现代的天气情况	WEATHER
衡水安平明天的天气	WEATHER
益阳天气预报	WEATHER
明天有没有雨吧	WEATHER
嗯小度小度你今天有没有雨	WEATHER
西青区今天天气怎么样	WEATHER
张掖的张掖市明天明天的天气	WEATHER
牡丹江现在多少度	WEATHER
沈阳市温度	WEATHER
户县的天气好不好	WEATHER
那兰州有没有暴风雨	WEATHER
前锋下雨了没有	WEATHER
有没有如家酒店	WEATHER
周围有没有渔具店	WEATHER
中途有没有酒店	WEATHER
到唐山现在多少钱啊多少公里	WEATHER
神池的天气报一下	WEATHER
我要去清源框子沟有玩有雨吗	WEATHER
温度请	WEATHER
的地方下不下雨	WEATHER
今天穿什么衣服合适	WEATHER
明天青岛有雨吗	WEATHER
动漫天气怎么样	WEATHER
嗯天气预报你能不能给我查查	WEATHER
小度小度绥棱明天天气怎么样	WEATHER
北京今天天气是什么	WEATHER
在哪三天有雨吗	WEATHER
是什么关山牧场现在是什么天气	WEATHER
有没有另一个路线呢	WEATHER
青龙县木头凳镇下雨了吗	WEATHER
采育有没有夜市	WEATHER
这两天天气	WEATHER
找二手渔具市场有多少度	WEATHER
哈尔滨十月份温度多少	WEATHER
长沙市今天天气	WEATHER
晚上兰州会下雨吗	WEATHER
小度小度小度小度小度小度有多少度小度小度小度小度小度小度小度小度小度	WEATHER
天气建设街佛山市	WEATHER
你对你自己有没有信心	WEATHER
小度沈阳今天天气多少度	WEATHER
今天李家庄吕家庄村有没有雨	WEATHER
附近有没有船厂	WEATHER
深圳现在温度是多少	WEATHER
今天天气对我来说	WEATHER
小度哈尔滨天气怎么样	WEATHER
杨柳青农场有没有花轿	WEATHER
今天魏县下雨吗	WEATHER
今天郑州几点下雨	WEATHER
威海那边天气怎么样	WEATHER
今天盖州市天气预报	WEATHER
这个今天天气	WEATHER
小度小度今天日本的天气怎么样	WEATHER
小度小度今天天气是	WEATHER
今天有雨吗我导航	WEATHER
明天几点开始下雨	WEATHER
有没有现货	WEATHER
黄山天气怎么样	WEATHER
蔚县今天天气	WEATHER
明天北安天气	WEATHER
有没有省道国道	WEATHER
今天有雨吗咱们东营	WEATHER
若尔盖的华府天气怎么样	WEATHER
今天沈阳市天气预报	WEATHER
广州今天中午天气	WEATHER
有没有误工了	WEATHER
前面有没有烧烤店	WEATHER
查看天气情况	WEATHER
查一下老君山的天气预报	WEATHER
今天一点明晚有没有雨	WEATHER
等一下会下雨吗	WEATHER
八卦天气情况	WEATHER
广河县钟会计镇的天气预报	WEATHER
我是午休天气预报武清客运站要多高天气武清	WEATHER
今天天气咋样啊小姐	WEATHER
查一下今天什么天气	WEATHER
我要上沙滩还游泳的啊我要去天气预报梅你播吗	WEATHER
顺义天气预报	WEATHER
我想去最冷的地方	WEATHER
终点站有没有宾馆	WEATHER
广饶今天有雨吗	WEATHER
临沂天气	WEATHER
镇远天气	WEATHER
今天天气好冷	WEATHER
我看下有没有又没有那啥	WEATHER
看看家里的天气	WEATHER
野三关明天天气怎么样	WEATHER
唐山星期六天气好吗	WEATHER
许昌今天天气	WEATHER
岩什么天气	WEATHER
新疆昌吉的天气	WEATHER
乐陵乐陵下雨没下雨啊落呢落玲查看乐婷下雨没下雨	WEATHER
和田地区于田县的天气怎么样	WEATHER
永寿今天天气如何	WEATHER
呼图壁县的气温是多少	WEATHER
小度突泉县杜尔基镇有没有雨	WEATHER
银川未来一周天气	WEATHER
顺路过去	MUSIC
小度啊不败	MUSIC
小度小度放点音乐	MUSIC
嘘嘘嘘嘘嘘嘘嘘嘘嘘嘘要	MUSIC
切换音乐	MUSIC
现在开始走	MUSIC
这个还有一个人	MUSIC
给我小度小度给我唱首歌	MUSIC
想问你你名字	MUSIC
冠军	MUSIC
小度你好你在哪里	MUSIC
你上面的	MUSIC
可不可以给唱首歌	MUSIC
瑞前面一个	MUSIC
万万万万	MUSIC
水晶	MUSIC
好江南	MUSIC
金孔雀ktv	MUSIC
放一首儿歌吧	MUSIC
小度小度有声音高一点	MUSIC
搜索终点	MUSIC
杨柳那个	MUSIC
啊回来吧	MUSIC
是什么歌呢	MUSIC
包容播放	MUSIC
小度唐拉雅秀	MUSIC
哦改变	MUSIC
小花花	MUSIC
我要到前面那个加油站	MUSIC
小度到在水一方d区	MUSIC
帮我的音乐音乐打开	MUSIC
请请帮我放一首歌	MUSIC
给我放一首春风十里	MUSIC
你给我调	MUSIC
你可以停了	MUSIC
请放一首谭维维的歌	MUSIC
这个傻子在	MUSIC
来个英文的	MUSIC
帮我切换林志玲的语音	MUSIC
秦皇岛呢	MUSIC
那就唱个歌	MUSIC
世纪缘木兰星	MUSIC
小度我正在听你说	MUSIC
小路呢	MUSIC
更改林志颖林志颖的声音	MUSIC
唱首歌来听	MUSIC
把音量调节到10%	MUSIC
哦西藏	MUSIC
公路好辛苦	MUSIC
额吉	MUSIC
帮我找帮我找一下最近的厕所在哪里	MUSIC
咔咔	MUSIC
乐观情绪	MUSIC
流浪地球语言呗	MUSIC
小度增加声音	MUSIC
甜甜海	MUSIC
你给我放首歌听呗	MUSIC
哦最后一个吧	MUSIC
切换我要切换	MUSIC
嗯小度小度唱首歌	MUSIC
醉美艺术人生	MUSIC
县暂停再暂停	MUSIC
我想去那个那个那个那个那个	MUSIC
我要我要找妈妈	MUSIC
那个那个那个商场叫什么呢	MUSIC
这个是上边那个	MUSIC
往南走了吗	MUSIC
请放一首健康歌	MUSIC
播放五环之歌	MUSIC
我要听歌曲塞北	MUSIC
啊切换吧从那个那个那个	MUSIC
音量85%	MUSIC
把音量调至最小	MUSIC
慢慢的来	MUSIC
给我切换那个酷狗音乐	MUSIC
最近的最近的终点中点	MUSIC
音乐培训	MUSIC
最近的李雪the	MUSIC
走吧走吧麻烦你	MUSIC
小度来给我找一下左岸	MUSIC
给我站住	MUSIC
你好调皮呀	MUSIC
我要后面那个了	MUSIC
小度小度你等一会	MUSIC
你的爸爸妈妈叫啥名字	MUSIC
华切换到音乐	MUSIC
放个歌呢	MUSIC
声音稍微开小一点	MUSIC
小度小度请听我说	MUSIC
世界风	MUSIC
唉你等一会儿吧	MUSIC
帮我查一下王艺翔	MUSIC
李佳傻子吗	MUSIC
继续前进吧	MUSIC
我要听张镐哲的歌	MUSIC
灯塔	MUSIC
小度小度切换回刚才的导航	MUSIC
这个地方叫什么	MUSIC
我们的时代	MUSIC
这条街吧	MUSIC
到加油站要多久	AIR_TICKET
兰西到哈尔滨西站多少公里	AIR_TICKET
从唐山到鲁北镇	AIR_TICKET
从河南省到到重庆市多少公里	AIR_TICKET
武汉到包头的机票	AIR_TICKET
还有多长时间到张龙	AIR_TICKET
从合肥到金华	AIR_TICKET
从河津到唐回漂流	AIR_TICKET
从聊城到漯河多远	AIR_TICKET
汗需要多长时间到达	AIR_TICKET
到南召县需要多久	AIR_TICKET
从这里到南阳	AIR_TICKET
河曲到天津	AIR_TICKET
北京到黄山北站	AIR_TICKET
从到香港	AIR_TICKET
到北京最到北京最远的飞机场	AIR_TICKET
到易水湖多长时间到	AIR_TICKET
武安到南昌	AIR_TICKET
从廊坊到三河县	AIR_TICKET
从兵马俑到西安	AIR_TICKET
齐齐哈尔到沈阳多少公里	AIR_TICKET
到流亭机场要用多长时间	AIR_TICKET
大名县到聊城市多少公里	AIR_TICKET
张家口到北京市多少公里	AIR_TICKET
珲春到哈尔滨多少公里	AIR_TICKET
从山东郓城到单县	AIR_TICKET
南京华府海底多长时间	AIR_TICKET
到重庆北站多少钱	AIR_TICKET
东莞到昆明多远	AIR_TICKET
到通化还要需要多长时间	AIR_TICKET
从惠阳到北京西站坐地铁	AIR_TICKET
秦皇岛到万家服务区的多长时间	AIR_TICKET
烟台到大连坐轮渡	AIR_TICKET
济宁到张家口	AIR_TICKET
西安到郴州多少公里	AIR_TICKET
就是嘉峪关去兰州的路上	AIR_TICKET
哈尔滨到大庆多远	AIR_TICKET
天津信息时间	AIR_TICKET
绥中到葫芦岛	AIR_TICKET
北京到大连	AIR_TICKET
贵阳到昆明多少公里	AIR_TICKET
上海到山东临沂	AIR_TICKET
海西要多长时间	AIR_TICKET
兰州到玉门多少公里	AIR_TICKET
到上海多少钱收费	AIR_TICKET
黄岛到青岛	AIR_TICKET
从鲁山到平顶山多远	AIR_TICKET
居然之家需要多长时间	AIR_TICKET
现在离六点还有多长时间	AIR_TICKET
大庆到青岛多少公里	AIR_TICKET
宝鸡到长春	AIR_TICKET
去广州的飞机票多少钱	AIR_TICKET
几点到葫芦岛	AIR_TICKET
从普者黑到九龙湖	AIR_TICKET
小鹿小鹿去北京珍保定到北京需要多长时间	AIR_TICKET
导航到德州到孟村	AIR_TICKET
嗯从北京西站到北京站打车需要多长时间	AIR_TICKET
开原到长春多少公里	AIR_TICKET
还有多长时间到高速收费站	AIR_TICKET
问我要做飞机	AIR_TICKET
从长白山到秦皇岛	AIR_TICKET
到吐鲁番还需多长时间	AIR_TICKET
到银川到几点	AIR_TICKET
嘉峪关到玉门多少公里	AIR_TICKET
到府路到入口	AIR_TICKET
北京西到中关村	AIR_TICKET
多长时间到通化市	AIR_TICKET
去大连大概用多长时间	AIR_TICKET
还多长时间	AIR_TICKET
从北京站到	AIR_TICKET
从华皮岭到唐山需要多长时间	AIR_TICKET
迈巴赫多少钱	AIR_TICKET
今天晚上几点到邢台	AIR_TICKET
从保定到蓬莱	AIR_TICKET
青州古城需要多长时间	AIR_TICKET
从西安到泾阳	AIR_TICKET
到最近的服务区还有多长时间	AIR_TICKET
从晋中到临汾	AIR_TICKET
从平遥到云岗石窟	AIR_TICKET
哦秦始皇兵马俑到飞机场多远	AIR_TICKET
还有多长时间到赤峰	AIR_TICKET
到运城还有多长时间	AIR_TICKET
到哈尔滨高速多少公里	AIR_TICKET
从从观澜到	AIR_TICKET
这个厂到西昌到西安	AIR_TICKET
苏家屯到抚顺	AIR_TICKET
到莱芜还有多长时间	AIR_TICKET
从绥化到美国纽约	AIR_TICKET
张北固原到平顶山多少公里	AIR_TICKET
去巴厘岛坐飞机	AIR_TICKET
黄村地铁站有没有到沙河地铁站	AIR_TICKET
从鲅鱼圈到铁西	AIR_TICKET
哈尔滨到松原多少公里	AIR_TICKET
秦皇岛到北戴河多少远	AIR_TICKET
坐飞机到沈阳多长时间	AIR_TICKET
曹县到青岛	AIR_TICKET
到汉沽多少公里	AIR_TICKET
还有多长时间多长时间到	AIR_TICKET
卢氏到平顶山	AIR_TICKET
汉中的青木川多长时间	AIR_TICKET
打电话给毛奇	TELE
我要打电话给付莹欣	TELE
打电话给13633813031	TELE
打电话给张行帅	TELE
小度小度我要打电话努力鑫	TELE
打电话给玉林哥	TELE
拨号给大哥	TELE
打电话给么一超	TELE
给旻斯芮打电话	TELE
给大连打电话	TELE
打电话给臭老婆	TELE
给牛珊珊打电话	TELE
打电话给奎子	TELE
打电话给新号丽华姐姐	TELE
拨打电话十雅兰	TELE
打电话给北屯谢总	TELE
帮我打一下薛青	TELE
我要给朱培打电话	TELE
打电话给10010	TELE
打电话给李文军	TELE
打电话给在干嘛	TELE
打电话给妈妈新号	TELE
给静生古交打电话	TELE
打电话给马雪量	TELE
打电话给张凯	TELE
打电话给15834860299	TELE
打电话给小霞	TELE
给杨哲打电话	TELE
打电话给张明军	TELE
我们打电话吗	TELE
打电话给李庆金	TELE
给徐加油打电话	TELE
我想给我老婆打电话	TELE
打电话给小红	TELE
给高瑞芝打电话	TELE
拨打福建省电话	TELE
晨曦给凤打电话	TELE
我要打电话给马国小武姐夫	TELE
打电话给阿爱芳芳	TELE
红不接地	TELE
打电话给5 8 5 5	TELE
打电话给鑫有妹妹	TELE
你给我拨个电话	TELE
给王峰打电话	TELE
打电话给林峰	TELE
打电话给13621226644	TELE
打电话给杨买珍	TELE
嗯给老公打个电话	TELE
给i你打电话	TELE
打电话给郑辉	TELE
帮我打电话给刘华兰	TELE
你呼叫小爱	TELE
给杨康打电话	TELE
帮我拨打电话吗	TELE
打电话王浩杰	TELE
打电话给陈秀刚	TELE
给孙秀玲打电话	TELE
打电话给宇顿高总	TELE
打电话给周伟	TELE
需要就挂了	TELE
打电话给李慧飞	TELE
嗯给我打电话给张建辉	TELE
给雷翁总打个电话	TELE
打电话给燕文	TELE
打电话给13672006358	TELE
打电话给18366130814	TELE
小度小度我要打电话给李超	TELE
博是的之前有的哥哥换电话号码了	TELE
打电话给赵其	TELE
拨打电话13901248280	TELE
不要换电话	TELE
打电话打电话给李燕春	TELE
打电话给同学磊	TELE
打电话给刘西彭	TELE
打电话给阿狸	TELE
打电话给峰龙	TELE
打电话给马伟	TELE
给刘峰打电话	TELE
给小龙打电话	TELE
小度小度呼叫红海燕在哪里	TELE
打电话给李云龙	TELE
打电话给胡老板	TELE
李红打电话给	TELE
打电话安泰联通	TELE
打电话给徐风语	TELE
打电话给孙敏	TELE
张琴打电话	TELE
哦个电话	TELE
给曹欣打电话	TELE
丹阳到郑州电话	TELE
打电话给娟度	TELE
呼叫张琴丽	TELE
拨打电话610	TELE
给平李打电话	TELE
拨打范辉的电话	TELE
呼叫宋婷婷	TELE
打电话给刘桂娜工作	TELE
打电话给陈云女神	TELE
打电话给长城鑫号	TELE
打电话给李海	TELE
天不刮风天不下雨天上有太阳	MUSICWEATHER
有没有伴呀	MUSICWEATHER
扎拉下雨了	MUSICWEATHER
天气好晴朗	MUSICWEATHER
今天有雨呀	MUSICWEATHER
空气能	MUSICWEATHER
西藏天气怎么样	MUSICWEATHER
有没有玩具	MUSICWEATHER
你那里下雪了吗	MUSICWEATHER
有没有轻音乐	MUSICWEATHER
又下雨了	MUSICWEATHER
下雨有多长时间	MUSICWEATHER
昨天明天的天气怎么样	MUSICWEATHER
有没有关联呢	MUSICWEATHER
有没有有没有其他路线	MUSICWEATHER
秦皇岛下雨	MUSICWEATHER
下雨了你知道不知道	MUSICWEATHER
有没有换媳妇呢	MUSICWEATHER
下雨那天	MUSICWEATHER
今天是什么天气	MUSICWEATHER
有没有鬼	MUSICWEATHER
有没有缘	MUSICWEATHER
给我找一下最近的冷面馆	MUSICWEATHER
有没有音乐呀	MUSICWEATHER
有没有合成	MUSICWEATHER
有没有信心	MUSICWEATHER
小度小度香港的天气怎么样	MUSICWEATHER
那个等一下下雨吗	MUSICWEATHER
前方有没有鬼	MUSICWEATHER
小度北京北京天气怎么样	MUSICWEATHER
三天以后的天气怎么样	MUSICWEATHER
那个啊怎么样冷面吧	MUSICWEATHER
那个他天气怎么样	MUSICWEATHER
小度小度明天会下雨吗	MUSICWEATHER
小度小度冷面	MUSICWEATHER
明天空气怎么样	MUSICWEATHER
小度小度秦皇岛后天天气怎么样	MUSICWEATHER
下雨了银河	MUSICWEATHER
帮我看一下等一下下不下雨	MUSICWEATHER
给我查一下前面的天气	MUSICWEATHER
黑马河天气怎么样	MUSICWEATHER
西藏温度怎么样	MUSICWEATHER
今天开始的天气怎么样	MUSICWEATHER
我说下雨	MUSICWEATHER
高山天气怎么样	MUSICWEATHER
小度小度下雨天	MUSICWEATHER
这个下雨呗	MUSICWEATHER
有没有其他路段	MUSICWEATHER
前方下雨	MUSICWEATHER
乌兰天气怎么样啊	MUSICWEATHER
能不能下雨	MUSICWEATHER
有没有这个人呢	MUSICWEATHER
小度今天有雨吧	MUSICWEATHER
有没有停车场呀	MUSICWEATHER
小度今天是什么天气	MUSICWEATHER
有没有切换	MUSICWEATHER
等会下雨呢	MUSICWEATHER
有没有船	MUSICWEATHER
有没有其他方案	MUSICWEATHER
有没有其他道路	MUSICWEATHER
有没有音乐	MUSICWEATHER
我们这下雨了	MUSICWEATHER
我要下雨	MUSICWEATHER
给宁下雨怎么样	MUSICWEATHER
下雨你在哪里	MUSICWEATHER
下雨商城	MUSICWEATHER
是否下雨	MUSICWEATHER
来了空气怎么样	MUSICWEATHER
我们这天气怎么样	MUSICWEATHER
播放音乐前面的天气	MUSICWEATHER
一路上天气怎么样	MUSICWEATHER
您好嗯明天明天天气怎么样	MUSICWEATHER
今天星期几啊天气怎么样	MUSICWEATHER
北京空气怎么样	MUSICWEATHER
下雨了下雨了下雨了	MUSICWEATHER
有没有拖鞋	MUSICWEATHER
明天的明天的天气怎么样	MUSICWEATHER
你是多少年	MUSICWEATHER
查一下有没有其他出口	MUSICWEATHER
后来下雨了	MUSICWEATHER
有没有小道	MUSICWEATHER
来一首雨一直下	MUSICWEATHER
有没有鱼酷	MUSICWEATHER
小度小度现在我这里的空气质量怎么样	MUSICWEATHER
今天有雨	MUSICWEATHER
有没有歌曲播放	MUSICWEATHER
有没有停车场呢	MUSICWEATHER
小度小度明天是晴天吗	MUSICWEATHER
小度小度今天天气好吗	MUSICWEATHER
给我查一下有没有毛是否	MUSICWEATHER
成都今天是什么天气	MUSICWEATHER
这个地方天气怎么样	MUSICWEATHER
有没有更换路线	MUSICWEATHER
空气	MUSICWEATHER
有没有草原	MUSICWEATHER
有没有歌	MUSICWEATHER
要下雪了	MUSICWEATHER
小度小度今天有雨吧	MUSICWEATHER
有没有包子铺	MUSICWEATHER
西安西安天气怎么样	MUSICWEATHER
